30
17
XXXXXXXXXXXXXXXXXXXXXXXXXXXXXX
X   XXX      XXXXXXXXX    $  X
XX$      XXXXXXXXXXX         X
XXX   XXXXXXXXX       XXXX   X
XXX   XXXXXXXXX    XXXXXX    X
XX   XXXXXXXX $  XXXXXXX    XX
X   XXXXXXXXXX  XXXXX      XXX
X     XXXXXXXXXXXXXXXX     XXX
X XXX    XXXXXXXXXXX     XXXXX
X XXX    XXXXXXXXXXXXXX    XXX
X $XXX    XXXXXXXXXXX      XXX
XXXXXXX       XXXX       XXXXX
XXXXX   XXXX            XXXXXX
XXXX  XXXXX   $   XXXXXXXXXXXX
XXX$ XXXXXX       XXXX  $X   X
X   XXXXXX                   X
XXXXXXXXXXXXXXXXXXXXXXXXXXXXXX